ID,Tolid,Tool,True Positives (TP),False Positives (FP),False Negatives (FN),True Negatives (TN),Precision,Recall,Accuracy,F1-score,Reference TP,Reference TN,Non classified,Reference chromosome scaffolds,Chromosome scaffolds classified
RC-2013,daFilPyra1,fcs,94,687,0,5231,0.1203585147247119,1.0,0.8857285429141717,0.21485714285714283,94,5918,-,94,94
RC-2013,daFilPyra1,tiara,94,5898,0,20,0.01568758344459279,1.0,0.018962075848303395,0.030890568517909955,94,5918,-,94,94
RC-2013,daFilPyra1,fcs+tiara,0,678,0,5240,0.0,0,0.8854342683338966,0,0,5918,-,94,0
RC-2013,daFilPyra1,sourmash_without_filters,94,1762,0,4156,0.05064655172413793,1.0,0.7069194943446441,0.09641025641025641,94,5918,29,94,94
RC-2013,daFilPyra1,sourmash_db_filter_published_assembly,93,827,0,5091,0.10108695652173913,1.0,0.8624188986857428,0.18361303060217177,93,5918,36,94,93
RC-2013,daFilPyra1,sourmash_db_filter_topN_3,93,665,0,5253,0.12269129287598944,1.0,0.8893694892696723,0.21856639247943596,93,5918,36,94,93
RC-2013,daFilPyra1,sourmash_db_filter_topN_10,93,673,0,5245,0.12140992167101827,1.0,0.8880385959075029,0.21653084982537835,93,5918,36,94,93
RC-2013,daFilPyra1,sourmash_db_filter_topN_50,93,753,0,5165,0.1099290780141844,1.0,0.8747296622858094,0.19808306709265178,93,5918,36,94,93
RC-2013,daFilPyra1,sourmash_db_filter_topN_100,93,764,0,5154,0.10851808634772463,1.0,0.8728996839128265,0.19578947368421054,93,5918,36,94,93
RC-2013,daFilPyra1,sourmash_db_filter_containment_0%,93,796,0,5122,0.1046119235095613,1.0,0.8675761104641491,0.1894093686354379,93,5918,36,94,93
RC-2013,daFilPyra1,sourmash_db_filter_containment_1%,93,796,0,5122,0.1046119235095613,1.0,0.8675761104641491,0.1894093686354379,93,5918,36,94,93
RC-2013,daFilPyra1,sourmash_db_filter_containment_10%,93,671,0,5247,0.12172774869109948,1.0,0.8883713192480452,0.21703617269544925,93,5918,36,94,93
RC-2013,daFilPyra1,sourmash_db_filter_containment_20%,76,660,17,5258,0.10326086956521739,0.8172043010752689,0.8873731492264182,0.18335343787696018,93,5918,36,94,76
RC-2013,daFilPyra1,sourmash_db_filter_kmers_2,93,759,0,5159,0.10915492957746478,1.0,0.8737314922641823,0.19682539682539682,93,5918,36,94,93
RC-2013,daFilPyra1,sourmash_db_filter_kmers_10,93,670,0,5248,0.1218872870249017,1.0,0.8885376809183164,0.21728971962616822,93,5918,36,94,93
RC-2013,daFilPyra1,sourmash_db_filter_kmers_50,21,649,72,5269,0.03134328358208955,0.22580645161290322,0.8800532357344868,0.05504587155963302,93,5918,36,94,21
RC-2013,daFilPyra1,sourmash_db_filter_kmers_100,20,620,73,5298,0.03125,0.21505376344086022,0.8847113625020795,0.054570259208731244,93,5918,36,94,20
RC-2016,gfHygHelo1,fcs,55,201,0,1836,0.21484375,1.0,0.9039196940726577,0.3536977491961415,55,2037,-,55,55
RC-2016,gfHygHelo1,tiara,55,291,0,1746,0.15895953757225434,1.0,0.8608986615678776,0.2743142144638404,55,2037,-,55,55
RC-2016,gfHygHelo1,fcs+tiara,1,171,0,1866,0.005813953488372093,1.0,0.9160942100098135,0.011560693641618497,1,2037,-,55,1
RC-2016,gfHygHelo1,sourmash_without_filters,55,1308,0,729,0.04035216434336023,1.0,0.37476099426386233,0.07757404795486601,55,2037,1204,55,55
RC-2016,gfHygHelo1,sourmash_db_filter_published_assembly,55,1308,0,729,0.04035216434336023,1.0,0.37476099426386233,0.07757404795486601,55,2037,1204,55,55
RC-2016,gfHygHelo1,sourmash_db_filter_topN_3,34,152,21,1885,0.1827956989247312,0.6181818181818182,0.9173040152963671,0.2821576763485477,55,2037,1204,55,34
RC-2016,gfHygHelo1,sourmash_db_filter_topN_10,34,153,21,1884,0.18181818181818182,0.6181818181818182,0.9168260038240917,0.2809917355371901,55,2037,1204,55,34
RC-2016,gfHygHelo1,sourmash_db_filter_topN_50,34,153,21,1884,0.18181818181818182,0.6181818181818182,0.9168260038240917,0.2809917355371901,55,2037,1204,55,34
RC-2016,gfHygHelo1,sourmash_db_filter_topN_100,34,153,21,1884,0.18181818181818182,0.6181818181818182,0.9168260038240917,0.2809917355371901,55,2037,1204,55,34
RC-2016,gfHygHelo1,sourmash_db_filter_containment_0%,34,159,21,1878,0.17616580310880828,0.6181818181818182,0.9139579349904398,0.27419354838709675,55,2037,1204,55,34
RC-2016,gfHygHelo1,sourmash_db_filter_containment_1%,34,159,21,1878,0.17616580310880828,0.6181818181818182,0.9139579349904398,0.27419354838709675,55,2037,1204,55,34
RC-2016,gfHygHelo1,sourmash_db_filter_containment_10%,34,2,21,2035,0.9444444444444444,0.6181818181818182,0.9890057361376673,0.7472527472527473,55,2037,1204,55,34
RC-2016,gfHygHelo1,sourmash_db_filter_containment_20%,34,0,21,2037,1.0,0.6181818181818182,0.989961759082218,0.7640449438202247,55,2037,1204,55,34
RC-2016,gfHygHelo1,sourmash_db_filter_kmers_2,34,141,21,1896,0.19428571428571428,0.6181818181818182,0.9225621414913958,0.2956521739130435,55,2037,1204,55,34
RC-2016,gfHygHelo1,sourmash_db_filter_kmers_10,34,1,21,2036,0.9714285714285714,0.6181818181818182,0.9894837476099426,0.7555555555555554,55,2037,1204,55,34
RC-2016,gfHygHelo1,sourmash_db_filter_kmers_50,0,0,55,2037,0,0.0,0.9737093690248566,0,55,2037,1204,55,0
RC-2016,gfHygHelo1,sourmash_db_filter_kmers_100,0,0,55,2037,0,0.0,0.9737093690248566,0,55,2037,1204,55,0
RC-2061,dcPolTetr1,fcs,43,1185,0,311,0.03501628664495114,1.0,0.2300194931773879,0.06766325727773408,43,1519,-,55,43
RC-2061,dcPolTetr1,tiara,43,1160,0,336,0.03574397339983375,1.0,0.24626380766731643,0.06902086677367576,43,1519,-,55,43
RC-2061,dcPolTetr1,fcs+tiara,0,1195,0,324,0.0,0,0.21329822251481237,0,0,1519,-,55,0
RC-2061,dcPolTetr1,sourmash_without_filters,48,1392,0,99,0.03333333333333333,1.0,0.09551656920077972,0.06451612903225806,48,1519,237,55,48
RC-2061,dcPolTetr1,sourmash_db_filter_published_assembly,48,1392,0,99,0.03333333333333333,1.0,0.09551656920077972,0.06451612903225806,48,1519,319,55,48
RC-2061,dcPolTetr1,sourmash_db_filter_topN_3,27,1155,21,341,0.02284263959390863,0.5625,0.23834196891191708,0.04390243902439024,48,1519,319,55,27
RC-2061,dcPolTetr1,sourmash_db_filter_topN_10,27,1156,21,340,0.02282333051563821,0.5625,0.23769430051813473,0.043866774979691305,48,1519,319,55,27
RC-2061,dcPolTetr1,sourmash_db_filter_topN_50,27,1157,21,339,0.022804054054054054,0.5625,0.23704663212435234,0.04383116883116883,48,1519,319,55,27
RC-2061,dcPolTetr1,sourmash_db_filter_topN_100,28,1159,20,337,0.02358887952822241,0.5833333333333334,0.23639896373056996,0.045344129554655874,48,1519,319,55,28
RC-2061,dcPolTetr1,sourmash_db_filter_containment_0%,28,1160,20,336,0.02356902356902357,0.5833333333333334,0.23575129533678757,0.045307443365695796,48,1519,319,55,28
RC-2061,dcPolTetr1,sourmash_db_filter_containment_1%,28,1160,20,336,0.02356902356902357,0.5833333333333334,0.23575129533678757,0.045307443365695796,48,1519,319,55,28
RC-2061,dcPolTetr1,sourmash_db_filter_containment_10%,27,1146,21,350,0.023017902813299233,0.5625,0.24417098445595856,0.04422604422604423,48,1519,319,55,27
RC-2061,dcPolTetr1,sourmash_db_filter_containment_20%,15,766,33,742,0.019206145966709345,0.3125,0.4865038560411311,0.0361881785283474,48,1519,319,55,15
RC-2061,dcPolTetr1,sourmash_db_filter_kmers_2,28,1160,20,336,0.02356902356902357,0.5833333333333334,0.23575129533678757,0.045307443365695796,48,1519,319,55,28
RC-2061,dcPolTetr1,sourmash_db_filter_kmers_10,27,1154,21,342,0.02286198137171888,0.5625,0.23898963730569947,0.04393816110659072,48,1519,319,55,27
RC-2061,dcPolTetr1,sourmash_db_filter_kmers_50,6,437,42,1076,0.013544018058690745,0.125,0.6931454196028187,0.024439918533604887,48,1519,319,55,6
RC-2061,dcPolTetr1,sourmash_db_filter_kmers_100,0,27,48,1492,0.0,0.0,0.9521378430121251,0,48,1519,319,55,0
RC-2065,ilIdaTrig2,fcs,35,13,0,2,0.7291666666666666,1.0,0.74,0.8433734939759037,35,15,-,35,35
RC-2065,ilIdaTrig2,tiara,35,13,0,2,0.7291666666666666,1.0,0.74,0.8433734939759037,35,15,-,35,35
RC-2065,ilIdaTrig2,fcs+tiara,0,13,0,2,0.0,0,0.13333333333333333,0,0,15,-,35,0
RC-2065,ilIdaTrig2,sourmash_without_filters,35,15,0,0,0.7,1.0,0.7,0.8235294117647058,35,15,11,35,35
RC-2065,ilIdaTrig2,sourmash_db_filter_published_assembly,35,15,0,0,0.7,1.0,0.7,0.8235294117647058,35,15,11,35,35
RC-2065,ilIdaTrig2,sourmash_db_filter_topN_3,26,15,9,0,0.6341463414634146,0.7428571428571429,0.52,0.6842105263157895,35,15,11,35,26
RC-2065,ilIdaTrig2,sourmash_db_filter_topN_10,26,15,9,0,0.6341463414634146,0.7428571428571429,0.52,0.6842105263157895,35,15,11,35,26
RC-2065,ilIdaTrig2,sourmash_db_filter_topN_50,26,15,9,0,0.6341463414634146,0.7428571428571429,0.52,0.6842105263157895,35,15,11,35,26
RC-2065,ilIdaTrig2,sourmash_db_filter_topN_100,26,15,9,0,0.6341463414634146,0.7428571428571429,0.52,0.6842105263157895,35,15,11,35,26
RC-2065,ilIdaTrig2,sourmash_db_filter_containment_0%,26,15,9,0,0.6341463414634146,0.7428571428571429,0.52,0.6842105263157895,35,15,11,35,26
RC-2065,ilIdaTrig2,sourmash_db_filter_containment_1%,26,15,9,0,0.6341463414634146,0.7428571428571429,0.52,0.6842105263157895,35,15,11,35,26
RC-2065,ilIdaTrig2,sourmash_db_filter_containment_10%,0,5,35,10,0.0,0.0,0.2,0,35,15,11,35,0
RC-2065,ilIdaTrig2,sourmash_db_filter_containment_20%,0,4,35,11,0.0,0.0,0.22,0,35,15,11,35,0
RC-2065,ilIdaTrig2,sourmash_db_filter_kmers_2,26,15,9,0,0.6341463414634146,0.7428571428571429,0.52,0.6842105263157895,35,15,11,35,26
RC-2065,ilIdaTrig2,sourmash_db_filter_kmers_10,23,6,12,9,0.7931034482758621,0.6571428571428571,0.64,0.71875,35,15,11,35,23
RC-2065,ilIdaTrig2,sourmash_db_filter_kmers_50,20,2,15,13,0.9090909090909091,0.5714285714285714,0.66,0.7017543859649122,35,15,11,35,20
RC-2065,ilIdaTrig2,sourmash_db_filter_kmers_100,20,2,15,13,0.9090909090909091,0.5714285714285714,0.66,0.7017543859649122,35,15,11,35,20
RC-2086,ilAriNici1,fcs,46,66,0,12,0.4107142857142857,1.0,0.46774193548387094,0.5822784810126582,46,78,-,46,46
RC-2086,ilAriNici1,tiara,46,64,0,14,0.41818181818181815,1.0,0.4838709677419355,0.5897435897435896,46,78,-,46,46
RC-2086,ilAriNici1,fcs+tiara,0,65,0,13,0.0,0,0.16666666666666666,0,0,78,-,46,0
RC-2086,ilAriNici1,sourmash_without_filters,46,77,0,1,0.37398373983739835,1.0,0.3790322580645161,0.5443786982248521,46,78,1,46,46
RC-2086,ilAriNici1,sourmash_db_filter_published_assembly,46,77,0,1,0.37398373983739835,1.0,0.3790322580645161,0.5443786982248521,46,78,1,46,46
RC-2086,ilAriNici1,sourmash_db_filter_topN_3,46,66,0,12,0.4107142857142857,1.0,0.46774193548387094,0.5822784810126582,46,78,1,46,46
RC-2086,ilAriNici1,sourmash_db_filter_topN_10,46,76,0,2,0.3770491803278688,1.0,0.3870967741935484,0.5476190476190476,46,78,1,46,46
RC-2086,ilAriNici1,sourmash_db_filter_topN_50,46,76,0,2,0.3770491803278688,1.0,0.3870967741935484,0.5476190476190476,46,78,1,46,46
RC-2086,ilAriNici1,sourmash_db_filter_topN_100,46,76,0,2,0.3770491803278688,1.0,0.3870967741935484,0.5476190476190476,46,78,1,46,46
RC-2086,ilAriNici1,sourmash_db_filter_containment_0%,46,76,0,2,0.3770491803278688,1.0,0.3870967741935484,0.5476190476190476,46,78,1,46,46
RC-2086,ilAriNici1,sourmash_db_filter_containment_1%,46,76,0,2,0.3770491803278688,1.0,0.3870967741935484,0.5476190476190476,46,78,1,46,46
RC-2086,ilAriNici1,sourmash_db_filter_containment_10%,46,65,0,13,0.4144144144144144,1.0,0.47580645161290325,0.5859872611464968,46,78,1,46,46
RC-2086,ilAriNici1,sourmash_db_filter_containment_20%,22,8,24,70,0.7333333333333333,0.4782608695652174,0.7419354838709677,0.5789473684210527,46,78,1,46,22
RC-2086,ilAriNici1,sourmash_db_filter_kmers_2,46,75,0,3,0.38016528925619836,1.0,0.3951612903225806,0.5508982035928144,46,78,1,46,46
RC-2086,ilAriNici1,sourmash_db_filter_kmers_10,46,64,0,14,0.41818181818181815,1.0,0.4838709677419355,0.5897435897435896,46,78,1,46,46
RC-2086,ilAriNici1,sourmash_db_filter_kmers_50,38,1,8,77,0.9743589743589743,0.8260869565217391,0.9274193548387096,0.8941176470588235,46,78,1,46,38
RC-2086,ilAriNici1,sourmash_db_filter_kmers_100,30,0,16,78,1.0,0.6521739130434783,0.8709677419354839,0.7894736842105263,46,78,1,46,30
RC-2093,ddArmRust1,fcs,113,2884,0,210,0.03770437103770437,1.0,0.10071718116619895,0.07266881028938907,113,3094,-,113,113
RC-2093,ddArmRust1,tiara,113,2902,0,192,0.03747927031509121,1.0,0.09510445899594637,0.07225063938618925,113,3094,-,113,113
RC-2093,ddArmRust1,fcs+tiara,0,2875,0,219,0.0,0,0.07078215901745313,0,0,3094,-,113,0
RC-2093,ddArmRust1,sourmash_without_filters,113,1516,0,1578,0.06936771025168816,1.0,0.5272840661053945,0.12973593570608496,113,3094,306,113,113
RC-2093,ddArmRust1,sourmash_db_filter_published_assembly,113,1516,0,1578,0.06936771025168816,1.0,0.5272840661053945,0.12973593570608496,113,3094,306,113,113
RC-2093,ddArmRust1,sourmash_db_filter_topN_3,111,1056,2,2038,0.09511568123393316,0.9823008849557522,0.6700966635484877,0.1734375,113,3094,306,113,111
RC-2093,ddArmRust1,sourmash_db_filter_topN_10,112,1076,1,2018,0.09427609427609428,0.9911504424778761,0.6641721234798877,0.17217524980784013,113,3094,306,113,112
RC-2093,ddArmRust1,sourmash_db_filter_topN_50,112,1156,1,1938,0.08832807570977919,0.9911504424778761,0.6392266916120986,0.16220130340333092,113,3094,306,113,112
RC-2093,ddArmRust1,sourmash_db_filter_topN_100,112,1179,1,1915,0.08675445391169635,0.9911504424778761,0.6320548799501091,0.15954415954415951,113,3094,306,113,112
RC-2093,ddArmRust1,sourmash_db_filter_containment_0%,112,1213,1,1881,0.08452830188679246,0.9911504424778761,0.6214530714062987,0.1557719054242003,113,3094,306,113,112
RC-2093,ddArmRust1,sourmash_db_filter_containment_1%,112,1213,1,1881,0.08452830188679246,0.9911504424778761,0.6214530714062987,0.1557719054242003,113,3094,306,113,112
RC-2093,ddArmRust1,sourmash_db_filter_containment_10%,69,1036,44,2058,0.06244343891402715,0.6106194690265486,0.6632366697848456,0.11330049261083744,113,3094,306,113,69
RC-2093,ddArmRust1,sourmash_db_filter_containment_20%,40,1028,73,2066,0.03745318352059925,0.35398230088495575,0.656688493919551,0.06773920406435224,113,3094,306,113,40
RC-2093,ddArmRust1,sourmash_db_filter_kmers_2,111,1116,2,1978,0.09046454767726161,0.9823008849557522,0.6513875896476458,0.16567164179104477,113,3094,306,113,111
RC-2093,ddArmRust1,sourmash_db_filter_kmers_10,109,1042,4,2052,0.0947002606429192,0.9646017699115044,0.6738384783286561,0.17246835443037972,113,3094,306,113,109
RC-2093,ddArmRust1,sourmash_db_filter_kmers_50,15,1012,98,2082,0.014605647517039922,0.13274336283185842,0.6538821328344246,0.026315789473684213,113,3094,306,113,15
RC-2093,ddArmRust1,sourmash_db_filter_kmers_100,14,843,99,2251,0.01633605600933489,0.12389380530973451,0.706267539756782,0.028865979381443297,113,3094,306,113,14
RC-2111,qdNanPoly8,fcs,67,83,0,1479,0.44666666666666666,1.0,0.949048496009822,0.6175115207373272,67,1562,-,67,67
RC-2111,qdNanPoly8,tiara,64,615,0,947,0.09425625920471281,1.0,0.6217712177121771,0.1722745625841184,64,1562,-,67,64
RC-2111,qdNanPoly8,fcs+tiara,1,47,0,1515,0.020833333333333332,1.0,0.9699296225207934,0.04081632653061225,1,1562,-,67,1
RC-2111,qdNanPoly8,sourmash_without_filters,65,1045,0,517,0.05855855855855856,1.0,0.35771358328211433,0.11063829787234042,65,1562,996,67,65
RC-2111,qdNanPoly8,sourmash_db_filter_published_assembly,54,1008,0,554,0.05084745762711865,1.0,0.37623762376237624,0.0967741935483871,54,1562,1611,67,54
RC-2111,qdNanPoly8,sourmash_db_filter_topN_3,0,0,54,1562,0,0.0,0.9665841584158416,0,54,1562,1611,67,0
RC-2111,qdNanPoly8,sourmash_db_filter_topN_10,0,0,54,1562,0,0.0,0.9665841584158416,0,54,1562,1611,67,0
RC-2111,qdNanPoly8,sourmash_db_filter_topN_50,0,0,54,1562,0,0.0,0.9665841584158416,0,54,1562,1611,67,0
RC-2111,qdNanPoly8,sourmash_db_filter_topN_100,0,0,54,1562,0,0.0,0.9665841584158416,0,54,1562,1611,67,0
RC-2111,qdNanPoly8,sourmash_db_filter_containment_0%,0,0,54,1562,0,0.0,0.9665841584158416,0,54,1562,1611,67,0
RC-2111,qdNanPoly8,sourmash_db_filter_containment_1%,0,0,54,1562,0,0.0,0.9665841584158416,0,54,1562,1611,67,0
RC-2111,qdNanPoly8,sourmash_db_filter_containment_10%,0,0,54,1562,0,0.0,0.9665841584158416,0,54,1562,1611,67,0
RC-2111,qdNanPoly8,sourmash_db_filter_containment_20%,0,0,54,1562,0,0.0,0.9665841584158416,0,54,1562,1611,67,0
RC-2111,qdNanPoly8,sourmash_db_filter_kmers_2,0,0,54,1562,0,0.0,0.9665841584158416,0,54,1562,1611,67,0
RC-2111,qdNanPoly8,sourmash_db_filter_kmers_10,0,0,54,1562,0,0.0,0.9665841584158416,0,54,1562,1611,67,0
RC-2111,qdNanPoly8,sourmash_db_filter_kmers_50,0,0,54,1562,0,0.0,0.9665841584158416,0,54,1562,1611,67,0
RC-2111,qdNanPoly8,sourmash_db_filter_kmers_100,0,0,54,1562,0,0.0,0.9665841584158416,0,54,1562,1611,67,0
RC-2122,ilScoChen1,fcs,35,2,0,33,0.9459459459459459,1.0,0.9714285714285714,0.9722222222222222,35,35,-,35,35
RC-2122,ilScoChen1,tiara,35,6,0,29,0.8536585365853658,1.0,0.9142857142857143,0.9210526315789475,35,35,-,35,35
RC-2122,ilScoChen1,fcs+tiara,0,2,0,33,0.0,0,0.9428571428571428,0,0,35,-,35,0
RC-2122,ilScoChen1,sourmash_without_filters,35,22,0,13,0.6140350877192983,1.0,0.6857142857142857,0.7608695652173912,35,35,14,35,35
RC-2122,ilScoChen1,sourmash_db_filter_published_assembly,35,22,0,13,0.6140350877192983,1.0,0.6857142857142857,0.7608695652173912,35,35,28,35,35
RC-2122,ilScoChen1,sourmash_db_filter_topN_3,35,5,0,30,0.875,1.0,0.9285714285714286,0.9333333333333333,35,35,28,35,35
RC-2122,ilScoChen1,sourmash_db_filter_topN_10,35,6,0,29,0.8536585365853658,1.0,0.9142857142857143,0.9210526315789475,35,35,28,35,35
RC-2122,ilScoChen1,sourmash_db_filter_topN_50,35,7,0,28,0.8333333333333334,1.0,0.9,0.9090909090909091,35,35,28,35,35
RC-2122,ilScoChen1,sourmash_db_filter_topN_100,35,7,0,28,0.8333333333333334,1.0,0.9,0.9090909090909091,35,35,28,35,35
RC-2122,ilScoChen1,sourmash_db_filter_containment_0%,35,7,0,28,0.8333333333333334,1.0,0.9,0.9090909090909091,35,35,28,35,35
RC-2122,ilScoChen1,sourmash_db_filter_containment_1%,35,7,0,28,0.8333333333333334,1.0,0.9,0.9090909090909091,35,35,28,35,35
RC-2122,ilScoChen1,sourmash_db_filter_containment_10%,1,0,34,35,1.0,0.02857142857142857,0.5142857142857142,0.05555555555555556,35,35,28,35,1
RC-2122,ilScoChen1,sourmash_db_filter_containment_20%,1,0,34,35,1.0,0.02857142857142857,0.5142857142857142,0.05555555555555556,35,35,28,35,1
RC-2122,ilScoChen1,sourmash_db_filter_kmers_2,34,6,1,29,0.85,0.9714285714285714,0.9,0.9066666666666667,35,35,28,35,34
RC-2122,ilScoChen1,sourmash_db_filter_kmers_10,34,3,1,32,0.918918918918919,0.9714285714285714,0.9428571428571428,0.9444444444444445,35,35,28,35,34
RC-2122,ilScoChen1,sourmash_db_filter_kmers_50,31,0,4,35,1.0,0.8857142857142857,0.9428571428571428,0.9393939393939393,35,35,28,35,31
RC-2122,ilScoChen1,sourmash_db_filter_kmers_100,31,0,4,35,1.0,0.8857142857142857,0.9428571428571428,0.9393939393939393,35,35,28,35,31
RC-2153,cbPteFili1,fcs,63,432,0,21,0.12727272727272726,1.0,0.16279069767441862,0.22580645161290322,63,453,-,63,63
RC-2153,cbPteFili1,tiara,63,431,0,22,0.12753036437246965,1.0,0.16472868217054262,0.22621184919210055,63,453,-,63,63
RC-2153,cbPteFili1,fcs+tiara,8,431,0,22,0.018223234624145785,1.0,0.0650759219088937,0.035794183445190156,8,453,-,63,8
RC-2153,cbPteFili1,sourmash_without_filters,63,448,0,5,0.1232876712328767,1.0,0.13178294573643412,0.2195121951219512,63,453,426,63,63
RC-2153,cbPteFili1,sourmash_db_filter_published_assembly,63,446,0,7,0.1237721021611002,1.0,0.13565891472868216,0.2202797202797203,63,453,550,63,63
RC-2153,cbPteFili1,sourmash_db_filter_topN_3,63,262,0,191,0.19384615384615383,1.0,0.49224806201550386,0.3247422680412371,63,453,550,63,63
RC-2153,cbPteFili1,sourmash_db_filter_topN_10,63,264,0,189,0.1926605504587156,1.0,0.4883720930232558,0.3230769230769231,63,453,550,63,63
RC-2153,cbPteFili1,sourmash_db_filter_topN_50,63,264,0,189,0.1926605504587156,1.0,0.4883720930232558,0.3230769230769231,63,453,550,63,63
RC-2153,cbPteFili1,sourmash_db_filter_topN_100,63,264,0,189,0.1926605504587156,1.0,0.4883720930232558,0.3230769230769231,63,453,550,63,63
RC-2153,cbPteFili1,sourmash_db_filter_containment_0%,63,265,0,188,0.19207317073170732,1.0,0.48643410852713176,0.32225063938618925,63,453,550,63,63
RC-2153,cbPteFili1,sourmash_db_filter_containment_1%,63,265,0,188,0.19207317073170732,1.0,0.48643410852713176,0.32225063938618925,63,453,550,63,63
RC-2153,cbPteFili1,sourmash_db_filter_containment_10%,15,264,48,189,0.053763440860215055,0.23809523809523808,0.3953488372093023,0.08771929824561403,63,453,550,63,15
RC-2153,cbPteFili1,sourmash_db_filter_containment_20%,1,262,62,191,0.0038022813688212928,0.015873015873015872,0.37209302325581395,0.0061349693251533735,63,453,550,63,1
RC-2153,cbPteFili1,sourmash_db_filter_kmers_2,63,264,0,189,0.1926605504587156,1.0,0.4883720930232558,0.3230769230769231,63,453,550,63,63
RC-2153,cbPteFili1,sourmash_db_filter_kmers_10,56,263,7,190,0.1755485893416928,0.8888888888888888,0.47674418604651164,0.2931937172774869,63,453,550,63,56
RC-2153,cbPteFili1,sourmash_db_filter_kmers_50,15,189,48,264,0.07352941176470588,0.23809523809523808,0.5406976744186046,0.11235955056179775,63,453,550,63,15
RC-2153,cbPteFili1,sourmash_db_filter_kmers_100,11,4,52,449,0.7333333333333333,0.1746031746031746,0.8914728682170543,0.28205128205128205,63,453,550,63,11
RC-2167,cbHetHete15,fcs,30,1312,0,43,0.022354694485842028,1.0,0.05270758122743682,0.04373177842565598,30,1355,-,30,30
RC-2167,cbHetHete15,tiara,30,1139,0,216,0.02566295979469632,1.0,0.1776173285198556,0.05004170141784821,30,1355,-,30,30
RC-2167,cbHetHete15,fcs+tiara,10,1123,0,232,0.0088261253309797,1.0,0.1772893772893773,0.017497812773403325,10,1355,-,30,10
RC-2167,cbHetHete15,sourmash_without_filters,30,1347,0,8,0.02178649237472767,1.0,0.027436823104693142,0.042643923240938165,30,1355,383,30,30
RC-2167,cbHetHete15,sourmash_db_filter_published_assembly,30,1346,0,9,0.02180232558139535,1.0,0.02815884476534296,0.042674253200568994,30,1355,1045,30,30
RC-2167,cbHetHete15,sourmash_db_filter_topN_3,30,809,0,546,0.03575685339690107,1.0,0.41588447653429605,0.06904487917146145,30,1355,1045,30,30
RC-2167,cbHetHete15,sourmash_db_filter_topN_10,30,809,0,546,0.03575685339690107,1.0,0.41588447653429605,0.06904487917146145,30,1355,1045,30,30
RC-2167,cbHetHete15,sourmash_db_filter_topN_50,30,809,0,546,0.03575685339690107,1.0,0.41588447653429605,0.06904487917146145,30,1355,1045,30,30
RC-2167,cbHetHete15,sourmash_db_filter_topN_100,30,809,0,546,0.03575685339690107,1.0,0.41588447653429605,0.06904487917146145,30,1355,1045,30,30
RC-2167,cbHetHete15,sourmash_db_filter_containment_0%,30,809,0,546,0.03575685339690107,1.0,0.41588447653429605,0.06904487917146145,30,1355,1045,30,30
RC-2167,cbHetHete15,sourmash_db_filter_containment_1%,30,809,0,546,0.03575685339690107,1.0,0.41588447653429605,0.06904487917146145,30,1355,1045,30,30
RC-2167,cbHetHete15,sourmash_db_filter_containment_10%,21,809,9,546,0.02530120481927711,0.7,0.40938628158844764,0.04883720930232558,30,1355,1045,30,21
RC-2167,cbHetHete15,sourmash_db_filter_containment_20%,1,808,29,547,0.0012360939431396785,0.03333333333333333,0.3956678700361011,0.0023837902264600714,30,1355,1045,30,1
RC-2167,cbHetHete15,sourmash_db_filter_kmers_2,30,809,0,546,0.03575685339690107,1.0,0.41588447653429605,0.06904487917146145,30,1355,1045,30,30
RC-2167,cbHetHete15,sourmash_db_filter_kmers_10,29,805,1,550,0.03477218225419664,0.9666666666666667,0.4180505415162455,0.06712962962962962,30,1355,1045,30,29
RC-2167,cbHetHete15,sourmash_db_filter_kmers_50,15,649,15,706,0.022590361445783132,0.5,0.5205776173285198,0.043227665706051875,30,1355,1045,30,15
RC-2167,cbHetHete15,sourmash_db_filter_kmers_100,10,116,20,1239,0.07936507936507936,0.3333333333333333,0.9018050541516246,0.1282051282051282,30,1355,1045,30,10
RC-2187,icCurGlan1,fcs,35,29,0,57,0.546875,1.0,0.7603305785123967,0.7070707070707071,35,86,-,35,35
RC-2187,icCurGlan1,tiara,33,23,0,63,0.5892857142857143,1.0,0.8067226890756303,0.7415730337078651,33,86,-,35,33
RC-2187,icCurGlan1,fcs+tiara,3,23,0,63,0.11538461538461539,1.0,0.7415730337078652,0.20689655172413793,3,86,-,35,3
RC-2187,icCurGlan1,sourmash_without_filters,35,73,0,13,0.32407407407407407,1.0,0.39669421487603307,0.48951048951048953,35,86,176,35,35
RC-2187,icCurGlan1,sourmash_db_filter_published_assembly,35,74,0,12,0.3211009174311927,1.0,0.3884297520661157,0.4861111111111111,35,86,177,35,35
RC-2187,icCurGlan1,sourmash_db_filter_topN_3,2,16,33,70,0.1111111111111111,0.05714285714285714,0.5950413223140496,0.07547169811320754,35,86,177,35,2
RC-2187,icCurGlan1,sourmash_db_filter_topN_10,2,20,33,66,0.09090909090909091,0.05714285714285714,0.5619834710743802,0.07017543859649122,35,86,177,35,2
RC-2187,icCurGlan1,sourmash_db_filter_topN_50,2,21,33,65,0.08695652173913043,0.05714285714285714,0.5537190082644629,0.06896551724137931,35,86,177,35,2
RC-2187,icCurGlan1,sourmash_db_filter_topN_100,2,21,33,65,0.08695652173913043,0.05714285714285714,0.5537190082644629,0.06896551724137931,35,86,177,35,2
RC-2187,icCurGlan1,sourmash_db_filter_containment_0%,2,21,33,65,0.08695652173913043,0.05714285714285714,0.5537190082644629,0.06896551724137931,35,86,177,35,2
RC-2187,icCurGlan1,sourmash_db_filter_containment_1%,2,21,33,65,0.08695652173913043,0.05714285714285714,0.5537190082644629,0.06896551724137931,35,86,177,35,2
RC-2187,icCurGlan1,sourmash_db_filter_containment_10%,0,4,35,82,0.0,0.0,0.6776859504132231,0,35,86,177,35,0
RC-2187,icCurGlan1,sourmash_db_filter_containment_20%,0,3,35,83,0.0,0.0,0.6859504132231405,0,35,86,177,35,0
RC-2187,icCurGlan1,sourmash_db_filter_kmers_2,2,5,33,81,0.2857142857142857,0.05714285714285714,0.6859504132231405,0.09523809523809522,35,86,177,35,2
RC-2187,icCurGlan1,sourmash_db_filter_kmers_10,1,2,34,84,0.3333333333333333,0.02857142857142857,0.7024793388429752,0.05263157894736842,35,86,177,35,1
RC-2187,icCurGlan1,sourmash_db_filter_kmers_50,0,2,35,84,0.0,0.0,0.6942148760330579,0,35,86,177,35,0
RC-2187,icCurGlan1,sourmash_db_filter_kmers_100,0,2,35,84,0.0,0.0,0.6942148760330579,0,35,86,177,35,0
RC-2197,icHypRumi1,fcs,18,21,0,3,0.46153846153846156,1.0,0.5,0.631578947368421,18,24,-,18,18
RC-2197,icHypRumi1,tiara,18,21,0,3,0.46153846153846156,1.0,0.5,0.631578947368421,18,24,-,18,18
RC-2197,icHypRumi1,fcs+tiara,7,21,0,3,0.25,1.0,0.3225806451612903,0.4,7,24,-,18,7
RC-2197,icHypRumi1,sourmash_without_filters,18,24,0,0,0.42857142857142855,1.0,0.42857142857142855,0.6,18,24,36,18,18
RC-2197,icHypRumi1,sourmash_db_filter_published_assembly,18,24,0,0,0.42857142857142855,1.0,0.42857142857142855,0.6,18,24,36,18,18
RC-2197,icHypRumi1,sourmash_db_filter_topN_3,4,14,14,10,0.2222222222222222,0.2222222222222222,0.3333333333333333,0.2222222222222222,18,24,36,18,4
RC-2197,icHypRumi1,sourmash_db_filter_topN_10,4,14,14,10,0.2222222222222222,0.2222222222222222,0.3333333333333333,0.2222222222222222,18,24,36,18,4
RC-2197,icHypRumi1,sourmash_db_filter_topN_50,4,14,14,10,0.2222222222222222,0.2222222222222222,0.3333333333333333,0.2222222222222222,18,24,36,18,4
RC-2197,icHypRumi1,sourmash_db_filter_topN_100,4,14,14,10,0.2222222222222222,0.2222222222222222,0.3333333333333333,0.2222222222222222,18,24,36,18,4
RC-2197,icHypRumi1,sourmash_db_filter_containment_0%,4,14,14,10,0.2222222222222222,0.2222222222222222,0.3333333333333333,0.2222222222222222,18,24,36,18,4
RC-2197,icHypRumi1,sourmash_db_filter_containment_1%,4,14,14,10,0.2222222222222222,0.2222222222222222,0.3333333333333333,0.2222222222222222,18,24,36,18,4
RC-2197,icHypRumi1,sourmash_db_filter_containment_10%,0,8,18,16,0.0,0.0,0.38095238095238093,0,18,24,36,18,0
RC-2197,icHypRumi1,sourmash_db_filter_containment_20%,0,8,18,16,0.0,0.0,0.38095238095238093,0,18,24,36,18,0
RC-2197,icHypRumi1,sourmash_db_filter_kmers_2,4,14,14,10,0.2222222222222222,0.2222222222222222,0.3333333333333333,0.2222222222222222,18,24,36,18,4
RC-2197,icHypRumi1,sourmash_db_filter_kmers_10,3,8,15,16,0.2727272727272727,0.16666666666666666,0.4523809523809524,0.20689655172413793,18,24,36,18,3
RC-2197,icHypRumi1,sourmash_db_filter_kmers_50,1,0,17,24,1.0,0.05555555555555555,0.5952380952380952,0.10526315789473684,18,24,36,18,1
RC-2197,icHypRumi1,sourmash_db_filter_kmers_100,0,0,18,24,0,0.0,0.5714285714285714,0,18,24,36,18,0
RC-2242,daAjuRept1,fcs,43,1664,0,504,0.025190392501464556,1.0,0.2473993668023519,0.04914285714285714,43,2168,-,43,43
RC-2242,daAjuRept1,tiara,42,1722,0,446,0.023809523809523808,1.0,0.22081447963800904,0.046511627906976744,42,2168,-,43,42
RC-2242,daAjuRept1,fcs+tiara,1,1647,0,521,0.0006067961165048543,1.0,0.24066390041493776,0.001212856276531231,1,2168,-,43,1
RC-2242,daAjuRept1,sourmash_without_filters,43,2081,0,87,0.02024482109227872,1.0,0.05879692446856626,0.03968620212275034,43,2168,439,43,43
RC-2242,daAjuRept1,sourmash_db_filter_published_assembly,41,2076,0,92,0.019367028814359942,1.0,0.06020823902218198,0.03799814643188137,41,2168,512,43,41
RC-2242,daAjuRept1,sourmash_db_filter_topN_3,2,1569,39,599,0.001273074474856779,0.04878048780487805,0.27206880941602535,0.0024813895781637717,41,2168,512,43,2
RC-2242,daAjuRept1,sourmash_db_filter_topN_10,3,1577,38,591,0.0018987341772151898,0.07317073170731707,0.2688999547306474,0.0037014188772362742,41,2168,512,43,3
RC-2242,daAjuRept1,sourmash_db_filter_topN_50,5,1592,36,576,0.0031308703819661866,0.12195121951219512,0.26301493888637395,0.006105006105006104,41,2168,512,43,5
RC-2242,daAjuRept1,sourmash_db_filter_topN_100,5,1601,36,567,0.00311332503113325,0.12195121951219512,0.2589406971480308,0.006071645415907711,41,2168,512,43,5
RC-2242,daAjuRept1,sourmash_db_filter_containment_0%,19,1616,22,552,0.011620795107033639,0.4634146341463415,0.2584880036215482,0.022673031026252982,41,2168,512,43,19
RC-2242,daAjuRept1,sourmash_db_filter_containment_1%,19,1616,22,552,0.011620795107033639,0.4634146341463415,0.2584880036215482,0.022673031026252982,41,2168,512,43,19
RC-2242,daAjuRept1,sourmash_db_filter_containment_10%,0,1538,41,630,0.0,0.0,0.28519692168401994,0,41,2168,512,43,0
RC-2242,daAjuRept1,sourmash_db_filter_containment_20%,0,1406,41,762,0.0,0.0,0.34495246717971934,0,41,2168,512,43,0
RC-2242,daAjuRept1,sourmash_db_filter_kmers_2,19,1603,22,565,0.011713933415536375,0.4634146341463415,0.26437301946582165,0.022850270595309682,41,2168,512,43,19
RC-2242,daAjuRept1,sourmash_db_filter_kmers_10,14,1553,27,615,0.008934269304403318,0.34146341463414637,0.28474422815753736,0.017412935323383085,41,2168,512,43,14
RC-2242,daAjuRept1,sourmash_db_filter_kmers_50,0,999,41,1169,0.0,0.0,0.5291987324581259,0,41,2168,512,43,0
RC-2242,daAjuRept1,sourmash_db_filter_kmers_100,0,225,41,1943,0.0,0.0,0.879583521955636,0,41,2168,512,43,0
RC-2258,xbBatHeck2,fcs,385,735,0,901,0.34375,1.0,0.636318654131618,0.5116279069767442,385,1636,-,385,385
RC-2258,xbBatHeck2,tiara,385,502,0,1134,0.43404735062006766,1.0,0.7516081147946561,0.6053459119496856,385,1636,-,385,385
RC-2258,xbBatHeck2,fcs+tiara,6,626,0,1010,0.00949367088607595,1.0,0.6187576126674786,0.018808777429467086,6,1636,-,385,6
RC-2258,xbBatHeck2,sourmash_without_filters,385,1601,0,35,0.19385699899295064,1.0,0.2078179119247897,0.3247574862927035,385,1636,65,385,385
RC-2258,xbBatHeck2,sourmash_db_filter_published_assembly,385,1462,0,174,0.20844612885760694,1.0,0.2765957446808511,0.3449820788530466,385,1636,968,385,385
RC-2258,xbBatHeck2,sourmash_db_filter_topN_3,380,548,5,1088,0.40948275862068967,0.987012987012987,0.7263730826323602,0.5788271134805789,385,1636,968,385,380
RC-2258,xbBatHeck2,sourmash_db_filter_topN_10,380,548,5,1088,0.40948275862068967,0.987012987012987,0.7263730826323602,0.5788271134805789,385,1636,968,385,380
RC-2258,xbBatHeck2,sourmash_db_filter_topN_50,380,551,5,1085,0.40816326530612246,0.987012987012987,0.7248886689757545,0.5775075987841946,385,1636,968,385,380
RC-2258,xbBatHeck2,sourmash_db_filter_topN_100,380,552,5,1084,0.40772532188841204,0.987012987012987,0.7243938644235527,0.5770690964312832,385,1636,968,385,380
RC-2258,xbBatHeck2,sourmash_db_filter_containment_0%,380,552,5,1084,0.40772532188841204,0.987012987012987,0.7243938644235527,0.5770690964312832,385,1636,968,385,380
RC-2258,xbBatHeck2,sourmash_db_filter_containment_1%,380,552,5,1084,0.40772532188841204,0.987012987012987,0.7243938644235527,0.5770690964312832,385,1636,968,385,380
RC-2258,xbBatHeck2,sourmash_db_filter_containment_10%,367,415,18,1221,0.46930946291560105,0.9532467532467532,0.7857496288965858,0.6289631533847472,385,1636,968,385,367
RC-2258,xbBatHeck2,sourmash_db_filter_containment_20%,254,294,131,1342,0.4635036496350365,0.6597402597402597,0.7897080653142009,0.5444801714898179,385,1636,968,385,254
RC-2258,xbBatHeck2,sourmash_db_filter_kmers_2,380,432,5,1204,0.46798029556650245,0.987012987012987,0.7837704106877783,0.6349206349206349,385,1636,968,385,380
RC-2258,xbBatHeck2,sourmash_db_filter_kmers_10,376,269,9,1367,0.5829457364341085,0.9766233766233766,0.8624443344878773,0.7300970873786408,385,1636,968,385,376
RC-2258,xbBatHeck2,sourmash_db_filter_kmers_50,349,12,36,1624,0.9667590027700831,0.9064935064935065,0.9762493814943097,0.935656836461126,385,1636,968,385,349
RC-2258,xbBatHeck2,sourmash_db_filter_kmers_100,305,2,80,1634,0.993485342019544,0.7922077922077922,0.9594260267194458,0.8815028901734105,385,1636,968,385,305
RC-2297,qqPhiCesp2,fcs,38,53,0,14,0.4175824175824176,1.0,0.49523809523809526,0.5891472868217055,38,67,-,38,38
RC-2297,qqPhiCesp2,tiara,38,46,0,21,0.4523809523809524,1.0,0.5619047619047619,0.6229508196721312,38,67,-,38,38
RC-2297,qqPhiCesp2,fcs+tiara,12,46,0,21,0.20689655172413793,1.0,0.4177215189873418,0.34285714285714286,12,67,-,38,12
RC-2297,qqPhiCesp2,sourmash_without_filters,38,61,0,6,0.3838383838383838,1.0,0.41904761904761906,0.5547445255474452,38,67,113,38,38
RC-2297,qqPhiCesp2,sourmash_db_filter_published_assembly,38,61,0,6,0.3838383838383838,1.0,0.41904761904761906,0.5547445255474452,38,67,113,38,38
RC-2297,qqPhiCesp2,sourmash_db_filter_topN_3,5,14,33,53,0.2631578947368421,0.13157894736842105,0.5523809523809524,0.17543859649122803,38,67,113,38,5
RC-2297,qqPhiCesp2,sourmash_db_filter_topN_10,5,31,33,36,0.1388888888888889,0.13157894736842105,0.3904761904761905,0.13513513513513511,38,67,113,38,5
RC-2297,qqPhiCesp2,sourmash_db_filter_topN_50,5,36,33,31,0.12195121951219512,0.13157894736842105,0.34285714285714286,0.12658227848101267,38,67,113,38,5
RC-2297,qqPhiCesp2,sourmash_db_filter_topN_100,5,36,33,31,0.12195121951219512,0.13157894736842105,0.34285714285714286,0.12658227848101267,38,67,113,38,5
RC-2297,qqPhiCesp2,sourmash_db_filter_containment_0%,5,36,33,31,0.12195121951219512,0.13157894736842105,0.34285714285714286,0.12658227848101267,38,67,113,38,5
RC-2297,qqPhiCesp2,sourmash_db_filter_containment_1%,5,36,33,31,0.12195121951219512,0.13157894736842105,0.34285714285714286,0.12658227848101267,38,67,113,38,5
RC-2297,qqPhiCesp2,sourmash_db_filter_containment_10%,1,2,37,65,0.3333333333333333,0.02631578947368421,0.6285714285714286,0.048780487804878044,38,67,113,38,1
RC-2297,qqPhiCesp2,sourmash_db_filter_containment_20%,0,0,38,67,0,0.0,0.638095238095238,0,38,67,113,38,0
RC-2297,qqPhiCesp2,sourmash_db_filter_kmers_2,5,22,33,45,0.18518518518518517,0.13157894736842105,0.47619047619047616,0.15384615384615383,38,67,113,38,5
RC-2297,qqPhiCesp2,sourmash_db_filter_kmers_10,5,2,33,65,0.7142857142857143,0.13157894736842105,0.6666666666666666,0.2222222222222222,38,67,113,38,5
RC-2297,qqPhiCesp2,sourmash_db_filter_kmers_50,2,0,36,67,1.0,0.05263157894736842,0.6571428571428571,0.1,38,67,113,38,2
RC-2297,qqPhiCesp2,sourmash_db_filter_kmers_100,0,0,38,67,0,0.0,0.638095238095238,0,38,67,113,38,0
RC-2409,cjHerHutc3,fcs,75,272,0,8,0.21613832853025935,1.0,0.23380281690140844,0.3554502369668246,75,280,-,75,75
RC-2409,cjHerHutc3,tiara,75,273,0,7,0.21551724137931033,1.0,0.23098591549295774,0.3546099290780142,75,280,-,75,75
RC-2409,cjHerHutc3,fcs+tiara,10,271,0,9,0.03558718861209965,1.0,0.06551724137931035,0.06872852233676977,10,280,-,75,10
RC-2409,cjHerHutc3,sourmash_without_filters,75,277,0,3,0.21306818181818182,1.0,0.21971830985915494,0.351288056206089,75,280,6,75,75
RC-2409,cjHerHutc3,sourmash_db_filter_published_assembly,74,165,0,115,0.30962343096234307,1.0,0.5338983050847458,0.47284345047923315,74,280,119,75,74
RC-2409,cjHerHutc3,sourmash_db_filter_topN_3,25,28,49,252,0.4716981132075472,0.33783783783783783,0.7824858757062146,0.3937007874015748,74,280,119,75,25
RC-2409,cjHerHutc3,sourmash_db_filter_topN_10,25,53,49,227,0.32051282051282054,0.33783783783783783,0.711864406779661,0.3289473684210526,74,280,119,75,25
RC-2409,cjHerHutc3,sourmash_db_filter_topN_50,25,71,49,209,0.2604166666666667,0.33783783783783783,0.6610169491525424,0.2941176470588236,74,280,119,75,25
RC-2409,cjHerHutc3,sourmash_db_filter_topN_100,25,74,49,206,0.25252525252525254,0.33783783783783783,0.652542372881356,0.28901734104046245,74,280,119,75,25
RC-2409,cjHerHutc3,sourmash_db_filter_containment_0%,25,137,49,143,0.15432098765432098,0.33783783783783783,0.4745762711864407,0.211864406779661,74,280,119,75,25
RC-2409,cjHerHutc3,sourmash_db_filter_containment_1%,25,137,49,143,0.15432098765432098,0.33783783783783783,0.4745762711864407,0.211864406779661,74,280,119,75,25
RC-2409,cjHerHutc3,sourmash_db_filter_containment_10%,25,22,49,258,0.5319148936170213,0.33783783783783783,0.7994350282485876,0.4132231404958678,74,280,119,75,25
RC-2409,cjHerHutc3,sourmash_db_filter_containment_20%,25,22,49,258,0.5319148936170213,0.33783783783783783,0.7994350282485876,0.4132231404958678,74,280,119,75,25
RC-2409,cjHerHutc3,sourmash_db_filter_kmers_2,25,47,49,233,0.3472222222222222,0.33783783783783783,0.7288135593220338,0.3424657534246575,74,280,119,75,25
RC-2409,cjHerHutc3,sourmash_db_filter_kmers_10,25,24,49,256,0.5102040816326531,0.33783783783783783,0.7937853107344632,0.4065040650406504,74,280,119,75,25
RC-2409,cjHerHutc3,sourmash_db_filter_kmers_50,0,0,74,280,0,0.0,0.7909604519774012,0,74,280,119,75,0
RC-2409,cjHerHutc3,sourmash_db_filter_kmers_100,0,0,74,280,0,0.0,0.7909604519774012,0,74,280,119,75,0
RC-2501,iyVulBima1,fcs,407,296,0,53,0.5789473684210527,1.0,0.6084656084656085,0.7333333333333334,407,349,-,407,407
RC-2501,iyVulBima1,tiara,395,349,0,0,0.5309139784946236,1.0,0.5309139784946236,0.6935908691834943,395,349,-,407,395
RC-2501,iyVulBima1,fcs+tiara,1,296,0,53,0.003367003367003367,1.0,0.15428571428571428,0.006711409395973153,1,349,-,407,1
RC-2501,iyVulBima1,sourmash_without_filters,407,348,0,1,0.5390728476821192,1.0,0.5396825396825397,0.7005163511187608,407,349,4,407,407
RC-2501,iyVulBima1,sourmash_db_filter_published_assembly,406,348,0,1,0.5384615384615384,1.0,0.5390728476821192,0.7000000000000001,406,349,179,407,406
RC-2501,iyVulBima1,sourmash_db_filter_topN_3,354,320,52,29,0.5252225519287834,0.8719211822660099,0.5072847682119205,0.6555555555555557,406,349,179,407,354
RC-2501,iyVulBima1,sourmash_db_filter_topN_10,354,327,52,22,0.5198237885462555,0.8719211822660099,0.49801324503311256,0.6513339466421344,406,349,179,407,354
RC-2501,iyVulBima1,sourmash_db_filter_topN_50,354,327,52,22,0.5198237885462555,0.8719211822660099,0.49801324503311256,0.6513339466421344,406,349,179,407,354
RC-2501,iyVulBima1,sourmash_db_filter_topN_100,354,327,52,22,0.5198237885462555,0.8719211822660099,0.49801324503311256,0.6513339466421344,406,349,179,407,354
RC-2501,iyVulBima1,sourmash_db_filter_containment_0%,354,327,52,22,0.5198237885462555,0.8719211822660099,0.49801324503311256,0.6513339466421344,406,349,179,407,354
RC-2501,iyVulBima1,sourmash_db_filter_containment_1%,354,327,52,22,0.5198237885462555,0.8719211822660099,0.49801324503311256,0.6513339466421344,406,349,179,407,354
RC-2501,iyVulBima1,sourmash_db_filter_containment_10%,128,185,278,164,0.40894568690095845,0.31527093596059114,0.38675496688741723,0.3560500695410292,406,349,179,407,128
RC-2501,iyVulBima1,sourmash_db_filter_containment_20%,13,76,393,273,0.14606741573033707,0.03201970443349754,0.37880794701986753,0.05252525252525254,406,349,179,407,13
RC-2501,iyVulBima1,sourmash_db_filter_kmers_2,282,309,124,40,0.47715736040609136,0.6945812807881774,0.42649006622516555,0.5656970912738214,406,349,179,407,282
RC-2501,iyVulBima1,sourmash_db_filter_kmers_10,237,257,169,92,0.4797570850202429,0.583743842364532,0.4357615894039735,0.5266666666666667,406,349,179,407,237
RC-2501,iyVulBima1,sourmash_db_filter_kmers_50,98,132,308,217,0.4260869565217391,0.2413793103448276,0.41721854304635764,0.3081761006289308,406,349,179,407,98
RC-2501,iyVulBima1,sourmash_db_filter_kmers_100,49,55,357,294,0.47115384615384615,0.1206896551724138,0.4543046357615894,0.19215686274509805,406,349,179,407,49
RC-2505,jaSteInte3,fcs,47,770,0,434,0.05752753977968176,1.0,0.3844924060751399,0.1087962962962963,47,1204,-,47,47
RC-2505,jaSteInte3,tiara,47,933,0,271,0.04795918367346939,1.0,0.2541966426858513,0.09152872444011684,47,1204,-,47,47
RC-2505,jaSteInte3,fcs+tiara,0,624,0,580,0.0,0,0.48172757475083056,0,0,1204,-,47,0
RC-2505,jaSteInte3,sourmash_without_filters,47,894,0,310,0.04994686503719448,1.0,0.2853717026378897,0.0951417004048583,47,1204,126,47,47
RC-2505,jaSteInte3,sourmash_db_filter_published_assembly,47,853,0,351,0.052222222222222225,1.0,0.3181454836131095,0.0992608236536431,47,1204,583,47,47
RC-2505,jaSteInte3,sourmash_db_filter_topN_3,41,319,6,885,0.11388888888888889,0.8723404255319149,0.7402078337330136,0.20147420147420148,47,1204,583,47,41
RC-2505,jaSteInte3,sourmash_db_filter_topN_10,41,333,6,871,0.10962566844919786,0.8723404255319149,0.7290167865707434,0.19477434679334915,47,1204,583,47,41
RC-2505,jaSteInte3,sourmash_db_filter_topN_50,41,369,6,835,0.1,0.8723404255319149,0.7002398081534772,0.17943107221006568,47,1204,583,47,41
RC-2505,jaSteInte3,sourmash_db_filter_topN_100,41,392,6,812,0.09468822170900693,0.8723404255319149,0.6818545163868905,0.17083333333333334,47,1204,583,47,41
RC-2505,jaSteInte3,sourmash_db_filter_containment_0%,41,445,6,759,0.08436213991769548,0.8723404255319149,0.6394884092725819,0.15384615384615385,47,1204,583,47,41
RC-2505,jaSteInte3,sourmash_db_filter_containment_1%,41,445,6,759,0.08436213991769548,0.8723404255319149,0.6394884092725819,0.15384615384615385,47,1204,583,47,41
RC-2505,jaSteInte3,sourmash_db_filter_containment_10%,0,68,47,1136,0.0,0.0,0.9080735411670664,0,47,1204,583,47,0
RC-2505,jaSteInte3,sourmash_db_filter_containment_20%,0,36,47,1168,0.0,0.0,0.9336530775379697,0,47,1204,583,47,0
RC-2505,jaSteInte3,sourmash_db_filter_kmers_2,41,139,6,1065,0.22777777777777777,0.8723404255319149,0.8840927258193445,0.36123348017621143,47,1204,583,47,41
RC-2505,jaSteInte3,sourmash_db_filter_kmers_10,40,42,7,1162,0.4878048780487805,0.851063829787234,0.9608313349320543,0.62015503875969,47,1204,583,47,40
RC-2505,jaSteInte3,sourmash_db_filter_kmers_50,16,1,31,1203,0.9411764705882353,0.3404255319148936,0.9744204636290967,0.5,47,1204,583,47,16
RC-2505,jaSteInte3,sourmash_db_filter_kmers_100,10,0,37,1204,1.0,0.2127659574468085,0.9704236610711431,0.3508771929824561,47,1204,583,47,10
RC-2515,xgEntOest1,fcs,309,1179,0,149,0.20766129032258066,1.0,0.2797800855222969,0.34390651085141904,309,1328,-,309,309
RC-2515,xgEntOest1,tiara,309,1020,0,308,0.2325056433408578,1.0,0.3769089798411729,0.3772893772893773,309,1328,-,309,309
RC-2515,xgEntOest1,fcs+tiara,0,1026,0,302,0.0,0,0.22740963855421686,0,0,1328,-,309,0
RC-2515,xgEntOest1,sourmash_without_filters,301,985,0,343,0.23405909797822705,1.0,0.3953345610804174,0.3793320730938878,301,1328,2552,309,301
RC-2515,xgEntOest1,sourmash_db_filter_published_assembly,301,985,0,343,0.23405909797822705,1.0,0.3953345610804174,0.3793320730938878,301,1328,2552,309,301
RC-2515,xgEntOest1,sourmash_db_filter_topN_3,3,0,298,1328,1.0,0.009966777408637873,0.8170656844689994,0.019736842105263157,301,1328,2552,309,3
RC-2515,xgEntOest1,sourmash_db_filter_topN_10,3,0,298,1328,1.0,0.009966777408637873,0.8170656844689994,0.019736842105263157,301,1328,2552,309,3
RC-2515,xgEntOest1,sourmash_db_filter_topN_50,4,4,297,1324,0.5,0.013289036544850499,0.8152240638428484,0.025889967637540454,301,1328,2552,309,4
RC-2515,xgEntOest1,sourmash_db_filter_topN_100,6,7,295,1321,0.46153846153846156,0.019933554817275746,0.8146101903007981,0.03821656050955413,301,1328,2552,309,6
RC-2515,xgEntOest1,sourmash_db_filter_containment_0%,11,27,290,1301,0.2894736842105263,0.036544850498338874,0.805402087170043,0.06489675516224189,301,1328,2552,309,11
RC-2515,xgEntOest1,sourmash_db_filter_containment_1%,11,27,290,1301,0.2894736842105263,0.036544850498338874,0.805402087170043,0.06489675516224189,301,1328,2552,309,11
RC-2515,xgEntOest1,sourmash_db_filter_containment_10%,2,1,299,1327,0.6666666666666666,0.006644518272425249,0.8158379373848987,0.013157894736842105,301,1328,2552,309,2
RC-2515,xgEntOest1,sourmash_db_filter_containment_20%,0,0,301,1328,0,0.0,0.8152240638428484,0,301,1328,2552,309,0
RC-2515,xgEntOest1,sourmash_db_filter_kmers_2,10,2,291,1326,0.8333333333333334,0.03322259136212625,0.8201350521792511,0.06389776357827476,301,1328,2552,309,10
RC-2515,xgEntOest1,sourmash_db_filter_kmers_10,3,0,298,1328,1.0,0.009966777408637873,0.8170656844689994,0.019736842105263157,301,1328,2552,309,3
RC-2515,xgEntOest1,sourmash_db_filter_kmers_50,0,0,301,1328,0,0.0,0.8152240638428484,0,301,1328,2552,309,0
RC-2515,xgEntOest1,sourmash_db_filter_kmers_100,0,0,301,1328,0,0.0,0.8152240638428484,0,301,1328,2552,309,0
RC-2649,laPotNata1,fcs,31,1009,0,36,0.02980769230769231,1.0,0.062267657992565055,0.05788982259570496,31,1045,-,31,31
RC-2649,laPotNata1,tiara,31,915,0,130,0.03276955602536998,1.0,0.1496282527881041,0.06345957011258957,31,1045,-,31,31
RC-2649,laPotNata1,fcs+tiara,0,976,0,69,0.0,0,0.0660287081339713,0,0,1045,-,31,0
RC-2649,laPotNata1,sourmash_without_filters,31,1041,0,4,0.028917910447761194,1.0,0.032527881040892194,0.056210335448776065,31,1045,112,31,31
RC-2649,laPotNata1,sourmash_db_filter_published_assembly,31,1039,0,6,0.02897196261682243,1.0,0.03438661710037175,0.056312443233424166,31,1045,390,31,31
RC-2649,laPotNata1,sourmash_db_filter_topN_3,0,806,31,239,0.0,0.0,0.22211895910780668,0,31,1045,390,31,0
RC-2649,laPotNata1,sourmash_db_filter_topN_10,0,850,31,195,0.0,0.0,0.1812267657992565,0,31,1045,390,31,0
RC-2649,laPotNata1,sourmash_db_filter_topN_50,0,862,31,183,0.0,0.0,0.17007434944237917,0,31,1045,390,31,0
RC-2649,laPotNata1,sourmash_db_filter_topN_100,0,862,31,183,0.0,0.0,0.17007434944237917,0,31,1045,390,31,0
RC-2649,laPotNata1,sourmash_db_filter_containment_0%,1,908,30,137,0.0011001100110011,0.03225806451612903,0.12825278810408922,0.002127659574468085,31,1045,390,31,1
RC-2649,laPotNata1,sourmash_db_filter_containment_1%,1,908,30,137,0.0011001100110011,0.03225806451612903,0.12825278810408922,0.002127659574468085,31,1045,390,31,1
RC-2649,laPotNata1,sourmash_db_filter_containment_10%,0,874,31,171,0.0,0.0,0.15892193308550187,0,31,1045,390,31,0
RC-2649,laPotNata1,sourmash_db_filter_containment_20%,0,430,31,615,0.0,0.0,0.5715613382899628,0,31,1045,390,31,0
RC-2649,laPotNata1,sourmash_db_filter_kmers_2,1,908,30,137,0.0011001100110011,0.03225806451612903,0.12825278810408922,0.002127659574468085,31,1045,390,31,1
RC-2649,laPotNata1,sourmash_db_filter_kmers_10,1,846,30,199,0.0011806375442739079,0.03225806451612903,0.18587360594795538,0.002277904328018223,31,1045,390,31,1
RC-2649,laPotNata1,sourmash_db_filter_kmers_50,0,292,31,753,0.0,0.0,0.699814126394052,0,31,1045,390,31,0
RC-2649,laPotNata1,sourmash_db_filter_kmers_100,0,6,31,1039,0.0,0.0,0.9656133828996283,0,31,1045,390,31,0
RC-2743,drTorJapo1,fcs,151,437,0,338,0.2568027210884354,1.0,0.5280777537796977,0.408660351826793,151,775,-,151,151
RC-2743,drTorJapo1,tiara,151,558,0,217,0.21297602256699577,1.0,0.39740820734341253,0.3511627906976745,151,775,-,151,151
RC-2743,drTorJapo1,fcs+tiara,4,416,0,359,0.009523809523809525,1.0,0.46598202824133506,0.01886792452830189,4,775,-,151,4
RC-2743,drTorJapo1,sourmash_without_filters,151,577,0,198,0.20741758241758243,1.0,0.37688984881209503,0.3435722411831627,151,775,151,151,151
RC-2743,drTorJapo1,sourmash_db_filter_published_assembly,150,576,0,199,0.2066115702479339,1.0,0.3772972972972973,0.34246575342465757,150,775,165,151,150
RC-2743,drTorJapo1,sourmash_db_filter_topN_3,143,416,7,359,0.2558139534883721,0.9533333333333334,0.5427027027027027,0.4033850493653033,150,775,165,151,143
RC-2743,drTorJapo1,sourmash_db_filter_topN_10,143,418,7,357,0.2549019607843137,0.9533333333333334,0.5405405405405406,0.4022503516174402,150,775,165,151,143
RC-2743,drTorJapo1,sourmash_db_filter_topN_50,143,421,7,354,0.25354609929078015,0.9533333333333334,0.5372972972972972,0.4005602240896359,150,775,165,151,143
RC-2743,drTorJapo1,sourmash_db_filter_topN_100,143,422,7,353,0.25309734513274335,0.9533333333333334,0.5362162162162162,0.39999999999999997,150,775,165,151,143
RC-2743,drTorJapo1,sourmash_db_filter_containment_0%,143,424,7,351,0.25220458553791886,0.9533333333333334,0.534054054054054,0.3988842398884239,150,775,165,151,143
RC-2743,drTorJapo1,sourmash_db_filter_containment_1%,143,424,7,351,0.25220458553791886,0.9533333333333334,0.534054054054054,0.3988842398884239,150,775,165,151,143
RC-2743,drTorJapo1,sourmash_db_filter_containment_10%,89,408,61,367,0.1790744466800805,0.5933333333333334,0.492972972972973,0.2751159196290572,150,775,165,151,89
RC-2743,drTorJapo1,sourmash_db_filter_containment_20%,76,403,74,372,0.15866388308977036,0.5066666666666667,0.4843243243243243,0.2416534181240064,150,775,165,151,76
RC-2743,drTorJapo1,sourmash_db_filter_kmers_2,140,409,10,366,0.2550091074681239,0.9333333333333333,0.547027027027027,0.4005722460658084,150,775,165,151,140
RC-2743,drTorJapo1,sourmash_db_filter_kmers_10,121,404,29,371,0.23047619047619047,0.8066666666666666,0.5318918918918919,0.3585185185185185,150,775,165,151,121
RC-2743,drTorJapo1,sourmash_db_filter_kmers_50,21,334,129,441,0.059154929577464786,0.14,0.49945945945945946,0.08316831683168317,150,775,165,151,21
RC-2743,drTorJapo1,sourmash_db_filter_kmers_100,10,106,140,669,0.08620689655172414,0.06666666666666667,0.7340540540540541,0.07518796992481204,150,775,165,151,10
RC-2788,caAndHook4,fcs,137,19,0,36,0.8782051282051282,1.0,0.9010416666666666,0.9351535836177475,137,55,-,137,137
RC-2788,caAndHook4,tiara,137,20,0,35,0.8726114649681529,1.0,0.8958333333333334,0.9319727891156463,137,55,-,137,137
RC-2788,caAndHook4,fcs+tiara,0,17,0,38,0.0,0,0.6909090909090909,0,0,55,-,137,0
RC-2788,caAndHook4,sourmash_without_filters,137,43,0,12,0.7611111111111111,1.0,0.7760416666666666,0.8643533123028391,137,55,26,137,137
RC-2788,caAndHook4,sourmash_db_filter_published_assembly,89,26,0,29,0.7739130434782608,1.0,0.8194444444444444,0.8725490196078431,89,55,117,137,89
RC-2788,caAndHook4,sourmash_db_filter_topN_3,0,0,89,55,0,0.0,0.3819444444444444,0,89,55,117,137,0
RC-2788,caAndHook4,sourmash_db_filter_topN_10,0,0,89,55,0,0.0,0.3819444444444444,0,89,55,117,137,0
RC-2788,caAndHook4,sourmash_db_filter_topN_50,0,0,89,55,0,0.0,0.3819444444444444,0,89,55,117,137,0
RC-2788,caAndHook4,sourmash_db_filter_topN_100,0,0,89,55,0,0.0,0.3819444444444444,0,89,55,117,137,0
RC-2788,caAndHook4,sourmash_db_filter_containment_0%,0,0,89,55,0,0.0,0.3819444444444444,0,89,55,117,137,0
RC-2788,caAndHook4,sourmash_db_filter_containment_1%,0,0,89,55,0,0.0,0.3819444444444444,0,89,55,117,137,0
RC-2788,caAndHook4,sourmash_db_filter_containment_10%,0,0,89,55,0,0.0,0.3819444444444444,0,89,55,117,137,0
RC-2788,caAndHook4,sourmash_db_filter_containment_20%,0,0,89,55,0,0.0,0.3819444444444444,0,89,55,117,137,0
RC-2788,caAndHook4,sourmash_db_filter_kmers_2,0,0,89,55,0,0.0,0.3819444444444444,0,89,55,117,137,0
RC-2788,caAndHook4,sourmash_db_filter_kmers_10,0,0,89,55,0,0.0,0.3819444444444444,0,89,55,117,137,0
RC-2788,caAndHook4,sourmash_db_filter_kmers_50,0,0,89,55,0,0.0,0.3819444444444444,0,89,55,117,137,0
RC-2788,caAndHook4,sourmash_db_filter_kmers_100,0,0,89,55,0,0.0,0.3819444444444444,0,89,55,117,137,0
RC-2826,xbHipHipp7,fcs,44,209,0,9859,0.17391304347826086,1.0,0.9793314873417721,0.29629629629629634,44,10068,-,44,44
RC-2826,xbHipHipp7,tiara,44,10068,0,0,0.00435126582278481,1.0,0.00435126582278481,0.008664828672705788,44,10068,-,44,44
RC-2826,xbHipHipp7,fcs+tiara,2,209,0,9859,0.009478672985781991,1.0,0.9792452830188679,0.018779342723004695,2,10068,-,44,2
RC-2826,xbHipHipp7,sourmash_without_filters,44,2119,0,7949,0.02034211742949607,1.0,0.7904469936708861,0.039873130946986864,44,10068,17,44,44
RC-2826,xbHipHipp7,sourmash_db_filter_published_assembly,44,1651,0,8417,0.025958702064896755,1.0,0.8367286392405063,0.05060379528464635,44,10068,101,44,44
RC-2826,xbHipHipp7,sourmash_db_filter_topN_3,41,98,3,9970,0.2949640287769784,0.9318181818181818,0.9900118670886076,0.448087431693989,44,10068,101,44,41
RC-2826,xbHipHipp7,sourmash_db_filter_topN_10,41,116,3,9952,0.2611464968152866,0.9318181818181818,0.9882318037974683,0.4079601990049751,44,10068,101,44,41
RC-2826,xbHipHipp7,sourmash_db_filter_topN_50,41,334,3,9734,0.10933333333333334,0.9318181818181818,0.9666732594936709,0.19570405727923626,44,10068,101,44,41
RC-2826,xbHipHipp7,sourmash_db_filter_topN_100,41,647,3,9421,0.059593023255813955,0.9318181818181818,0.9357199367088608,0.11202185792349728,44,10068,101,44,41
RC-2826,xbHipHipp7,sourmash_db_filter_containment_0%,42,1597,2,8471,0.025625381330079317,0.9545454545454546,0.8418710443037974,0.049910873440285206,44,10068,101,44,42
RC-2826,xbHipHipp7,sourmash_db_filter_containment_1%,42,1597,2,8471,0.025625381330079317,0.9545454545454546,0.8418710443037974,0.049910873440285206,44,10068,101,44,42
RC-2826,xbHipHipp7,sourmash_db_filter_containment_10%,18,77,26,9991,0.18947368421052632,0.4090909090909091,0.989814082278481,0.2589928057553957,44,10068,101,44,18
RC-2826,xbHipHipp7,sourmash_db_filter_containment_20%,2,23,42,10045,0.08,0.045454545454545456,0.9935719936708861,0.057971014492753624,44,10068,101,44,2
RC-2826,xbHipHipp7,sourmash_db_filter_kmers_2,40,637,4,9431,0.059084194977843424,0.9090909090909091,0.9366099683544303,0.11095700416088765,44,10068,101,44,40
RC-2826,xbHipHipp7,sourmash_db_filter_kmers_10,39,40,5,10028,0.4936708860759494,0.8863636363636364,0.9955498417721519,0.6341463414634146,44,10068,101,44,39
RC-2826,xbHipHipp7,sourmash_db_filter_kmers_50,30,4,14,10064,0.8823529411764706,0.6818181818181818,0.9982199367088608,0.7692307692307693,44,10068,101,44,30
RC-2826,xbHipHipp7,sourmash_db_filter_kmers_100,29,3,15,10065,0.90625,0.6590909090909091,0.9982199367088608,0.763157894736842,44,10068,101,44,29
RC-2962,iyAndClar1,fcs,23,21,0,15,0.5227272727272727,1.0,0.6440677966101694,0.6865671641791045,23,36,-,23,23
RC-2962,iyAndClar1,tiara,23,36,0,0,0.3898305084745763,1.0,0.3898305084745763,0.5609756097560975,23,36,-,23,23
RC-2962,iyAndClar1,fcs+tiara,5,21,0,15,0.19230769230769232,1.0,0.4878048780487805,0.32258064516129037,5,36,-,23,5
RC-2962,iyAndClar1,sourmash_without_filters,23,35,0,1,0.39655172413793105,1.0,0.4067796610169492,0.5679012345679012,23,36,691,23,23
RC-2962,iyAndClar1,sourmash_db_filter_published_assembly,23,35,0,1,0.39655172413793105,1.0,0.4067796610169492,0.5679012345679012,23,36,691,23,23
RC-2962,iyAndClar1,sourmash_db_filter_topN_3,23,10,0,26,0.696969696969697,1.0,0.8305084745762712,0.8214285714285715,23,36,691,23,23
RC-2962,iyAndClar1,sourmash_db_filter_topN_10,23,18,0,18,0.5609756097560976,1.0,0.6949152542372882,0.71875,23,36,691,23,23
RC-2962,iyAndClar1,sourmash_db_filter_topN_50,23,20,0,16,0.5348837209302325,1.0,0.6610169491525424,0.6969696969696969,23,36,691,23,23
RC-2962,iyAndClar1,sourmash_db_filter_topN_100,23,20,0,16,0.5348837209302325,1.0,0.6610169491525424,0.6969696969696969,23,36,691,23,23
RC-2962,iyAndClar1,sourmash_db_filter_containment_0%,23,20,0,16,0.5348837209302325,1.0,0.6610169491525424,0.6969696969696969,23,36,691,23,23
RC-2962,iyAndClar1,sourmash_db_filter_containment_1%,23,20,0,16,0.5348837209302325,1.0,0.6610169491525424,0.6969696969696969,23,36,691,23,23
RC-2962,iyAndClar1,sourmash_db_filter_containment_10%,17,15,6,21,0.53125,0.7391304347826086,0.6440677966101694,0.6181818181818182,23,36,691,23,17
RC-2962,iyAndClar1,sourmash_db_filter_containment_20%,0,13,23,23,0.0,0.0,0.3898305084745763,0,23,36,691,23,0
RC-2962,iyAndClar1,sourmash_db_filter_kmers_2,21,19,2,17,0.525,0.9130434782608695,0.6440677966101694,0.6666666666666667,23,36,691,23,21
RC-2962,iyAndClar1,sourmash_db_filter_kmers_10,20,15,3,21,0.5714285714285714,0.8695652173913043,0.6949152542372882,0.689655172413793,23,36,691,23,20
RC-2962,iyAndClar1,sourmash_db_filter_kmers_50,18,13,5,23,0.5806451612903226,0.782608695652174,0.6949152542372882,0.6666666666666667,23,36,691,23,18
RC-2962,iyAndClar1,sourmash_db_filter_kmers_100,17,9,6,27,0.6538461538461539,0.7391304347826086,0.7457627118644068,0.693877551020408,23,36,691,23,17
RC-3033,qqTetUrti3,fcs,10,6,0,228,0.625,1.0,0.9754098360655737,0.7692307692307693,10,234,-,10,10
RC-3033,qqTetUrti3,tiara,10,234,0,0,0.040983606557377046,1.0,0.040983606557377046,0.07874015748031496,10,234,-,10,10
RC-3033,qqTetUrti3,fcs+tiara,0,6,0,228,0.0,0,0.9743589743589743,0,0,234,-,10,0
RC-3033,qqTetUrti3,sourmash_without_filters,10,103,0,131,0.08849557522123894,1.0,0.5778688524590164,0.1626016260162602,10,234,97,10,10
RC-3033,qqTetUrti3,sourmash_db_filter_published_assembly,10,103,0,131,0.08849557522123894,1.0,0.5778688524590164,0.1626016260162602,10,234,97,10,10
RC-3033,qqTetUrti3,sourmash_db_filter_topN_3,10,4,0,230,0.7142857142857143,1.0,0.9836065573770492,0.8333333333333333,10,234,97,10,10
RC-3033,qqTetUrti3,sourmash_db_filter_topN_10,10,4,0,230,0.7142857142857143,1.0,0.9836065573770492,0.8333333333333333,10,234,97,10,10
RC-3033,qqTetUrti3,sourmash_db_filter_topN_50,10,4,0,230,0.7142857142857143,1.0,0.9836065573770492,0.8333333333333333,10,234,97,10,10
RC-3033,qqTetUrti3,sourmash_db_filter_topN_100,10,4,0,230,0.7142857142857143,1.0,0.9836065573770492,0.8333333333333333,10,234,97,10,10
RC-3033,qqTetUrti3,sourmash_db_filter_containment_0%,10,8,0,226,0.5555555555555556,1.0,0.9672131147540983,0.7142857142857143,10,234,97,10,10
RC-3033,qqTetUrti3,sourmash_db_filter_containment_1%,10,8,0,226,0.5555555555555556,1.0,0.9672131147540983,0.7142857142857143,10,234,97,10,10
RC-3033,qqTetUrti3,sourmash_db_filter_containment_10%,10,3,0,231,0.7692307692307693,1.0,0.9877049180327869,0.8695652173913044,10,234,97,10,10
RC-3033,qqTetUrti3,sourmash_db_filter_containment_20%,10,1,0,233,0.9090909090909091,1.0,0.9959016393442623,0.9523809523809523,10,234,97,10,10
RC-3033,qqTetUrti3,sourmash_db_filter_kmers_2,10,3,0,231,0.7692307692307693,1.0,0.9877049180327869,0.8695652173913044,10,234,97,10,10
RC-3033,qqTetUrti3,sourmash_db_filter_kmers_10,10,1,0,233,0.9090909090909091,1.0,0.9959016393442623,0.9523809523809523,10,234,97,10,10
RC-3033,qqTetUrti3,sourmash_db_filter_kmers_50,10,0,0,234,1.0,1.0,1.0,1.0,10,234,97,10,10
RC-3033,qqTetUrti3,sourmash_db_filter_kmers_100,10,0,0,234,1.0,1.0,1.0,1.0,10,234,97,10,10
